1111111111111
110000P000011
1100000000011
110000C000011
1100000000011
110000C000011
1100000000011
110000E000011
1111111111111
